1111111111111111111111111111111111111111111111111111111111111111111111111111111111111111111111111111111111111111111111111111111111111111111111111111111111111111111111111111111111111111111111111111111111111111111111111111111111111111
                                                                                                                                                         1111111111111111111111111111111111111111111111111111111111111111111111111111111
                                                                                                                                                           11111111111111111111111111111111                            11111111111111111
                                                                                                                                                             11111111111111111111111111111                                11111111111111
                                                                                                                              22                               1111111111111111111111111                                     11111111111
                                    11                                                                                     1111111                                                                      22      22                     3
                                11                                                                                       11111111111              1     1                                       11  111111111111111111111111111111111111
                        2  11                          11  11        222                                       22      111111111111111                                                       1  11  111111111111111111111111111111111111
                   111111              11   111   111          111111111            1111   111   111    11111111111111111111111111111111                       111122        22          1   1  11  111111111111111111111111111111111111
                   1    122222222222222112222222222222222221                 1112211111122222222222222221111111111111111111111111111111111        2     2      1111111111111111111111112212221221111111111111111111111111111111111111111
1111111111111111111111111111111111111111111111111111111111111111111111111111111111111111111111111111111111111111111111111111111111111111111111111111111111111111111111111111111111111111111111111111111111111111111111111111111111111111