1111111111111111111111111111111111111111111111111111111111111111111111111111111111111111111111111111111111111111111111111111111111111111111111111111111111111111111111111111111111111111111111111111111111111111
                                                                  1  1  1                                                                                                                                      3
                                                                  1  1  1                                                                                                                                      3
                                                                  1  1  1                                                                                                                                      3
                                              22                  1  1  1                                           22222222222222222222222222                                              111111111   11111111
                                     111   11111111               1  1  1                        111   1111   11111111111111111111111111111111                                         112                     1
                            1111111                               1  1  1               111111122222222                                       11                        22        112                          1
                         12                                                         11         11111111                                         1             2  111111111111111                               1
                22    12                                                        11221111              1                111                      1        111111                       1                        1
            111111111111111111122222222222222222222222      2     2  2  2       11111111112222222222221             1111  2     22    2             2    1    1         222222        12222222222222222222222221
1111111111111111111111111111111111111111111111111111111111111111111111111111111111111111111111111111111111111111111111111111111111111111111111111111111111111111111111111111111111111111111111111111111111111111